.WWWWWWWWW
.WPWWWW..W
.WBW.....W
.W.W..WW.W
.W.WW.WW.W
WW.WW.WW.W
W..WW.WW.W
W.....WW.W
WWWW..WWTW
...WWWWWWW